date,new,cumulative,doubleFlagTest,doubleFlagLabel,shaded
2020-01-15,1,1,1,,18
2020-01-16,0,1,1,,
2020-01-17,0,1,0,,
2020-01-18,0,1,0,,
2020-01-19,0,1,0,,
2020-01-20,0,1,0,,
2020-01-21,1,2,1,,
2020-01-22,2,4,1,,
2020-01-23,0,4,0,,
2020-01-24,2,6,0,,
2020-01-25,1,7,0,,
2020-01-26,0,7,0,,
2020-01-27,1,8,1,,
2020-01-28,1,9,0,,
2020-01-29,0,9,0,,
2020-01-30,0,9,0,,
2020-01-31,0,9,0,,
2020-02-01,2,11,0,,
2020-02-02,0,11,0,,
2020-02-03,0,11,0,,
2020-02-04,0,11,0,,
2020-02-05,1,12,0,,
2020-02-06,0,12,0,,
2020-02-07,0,12,0,,
2020-02-08,1,13,0,,
2020-02-09,1,14,0,,
2020-02-10,3,17,1,,
2020-02-11,0,17,0,,
2020-02-12,1,18,0,,
2020-02-13,2,20,0,,
2020-02-14,4,24,0,,
2020-02-15,4,28,0,,
2020-02-16,3,31,0,,
2020-02-17,1,32,0,,
2020-02-18,1,33,0,,
2020-02-19,1,34,1,,
2020-02-20,7,41,0,,
2020-02-21,3,44,0,,
2020-02-22,7,51,0,,
2020-02-23,11,62,0,,
2020-02-24,11,73,1,,
2020-02-25,10,83,0,,
2020-02-26,6,89,0,,
2020-02-27,12,101,0,,
2020-02-28,17,118,0,,
2020-02-29,26,144,0,,
2020-03-01,41,185,1,,
2020-03-02,37,222,0,,
2020-03-03,44,266,0,,
2020-03-04,46,312,0,,
2020-03-05,52,364,0,,
2020-03-06,63,427,1,,
2020-03-07,77,504,0,,
2020-03-08,106,610,0,,
2020-03-09,187,797,0,,
2020-03-10,214,1011,1,,
2020-03-11,239,1250,0,,
2020-03-12,297,1547,0,,
2020-03-13,361,1908,0,,
2020-03-14,359,2267,1,,
2020-03-15,453,2720,0,,
2020-03-16,619,3339,0,,
2020-03-17,654,3993,0,,
2020-03-18,782,4775,1,,
2020-03-19,618,5393,0,,
2020-03-20,764,6157,0,,
2020-03-21,667,6824,0,,
2020-03-22,618,7442,0,,
2020-03-23,750,8192,0,,
2020-03-24,664,8856,0,,
2020-03-25,668,9524,0,,
2020-03-26,608,10132,1,,
2020-03-27,608,10740,0,,
2020-03-28,574,11314,0,,
2020-03-29,471,11785,0,,
2020-03-30,623,12408,0,,
2020-03-31,474,12882,0,,
2020-04-01,590,13472,0,,
2020-04-02,517,13989,0,,
2020-04-03,554,14543,0,,
2020-04-04,440,14983,0,,
2020-04-05,458,15441,0,,
2020-04-06,587,16028,0,,
2020-04-07,600,16628,0,,
2020-04-08,595,17223,0,,
2020-04-09,667,17890,0,,
2020-04-10,742,18632,0,,
2020-04-11,704,19336,0,,
2020-04-12,608,19944,0,,
2020-04-13,985,20929,1,,
2020-04-14,792,21721,0,,
2020-04-15,876,22597,0,,
2020-04-16,764,23361,0,,
2020-04-17,836,24197,0,,
2020-04-18,668,24865,0,,
2020-04-19,408,25273,0,,
2020-04-20,620,25893,0,,
2020-04-21,457,26350,0,,
2020-04-22,497,26847,0,,
2020-04-23,487,27334,0,,
2020-04-24,443,27777,0,,
2020-04-25,358,28135,1,,
2020-04-26,218,28353,0,,
2020-04-27,270,28623,0,,
2020-04-28,117,28740,0,,
2020-04-29,29,28769,0,,
2020-04-30,1,28770,0,,