date,new,cumulative,doubleFlagTest,doubleFlagLabel,shaded
2020-01-15,1,1,1,,18
2020-01-16,0,1,1,,
2020-01-17,0,1,0,,
2020-01-18,0,1,0,,
2020-01-19,0,1,0,,
2020-01-20,0,1,0,,
2020-01-21,1,2,1,,
2020-01-22,2,4,1,,
2020-01-23,0,4,0,,
2020-01-24,2,6,0,,
2020-01-25,1,7,0,,
2020-01-26,0,7,0,,
2020-01-27,1,8,1,,
2020-01-28,1,9,0,,
2020-01-29,0,9,0,,
2020-01-30,0,9,0,,
2020-01-31,0,9,0,,
2020-02-01,2,11,0,,
2020-02-02,0,11,0,,
2020-02-03,0,11,0,,
2020-02-04,0,11,0,,
2020-02-05,1,12,0,,
2020-02-06,0,12,0,,
2020-02-07,0,12,0,,
2020-02-08,1,13,0,,
2020-02-09,1,14,0,,
2020-02-10,3,17,1,,
2020-02-11,0,17,0,,
2020-02-12,1,18,0,,
2020-02-13,2,20,0,,
2020-02-14,4,24,0,,
2020-02-15,4,28,0,,
2020-02-16,3,31,0,,
2020-02-17,1,32,0,,
2020-02-18,1,33,0,,
2020-02-19,1,34,1,,
2020-02-20,7,41,0,,
2020-02-21,3,44,0,,
2020-02-22,7,51,0,,
2020-02-23,11,62,0,,
2020-02-24,11,73,1,,
2020-02-25,10,83,0,,
2020-02-26,6,89,0,,
2020-02-27,12,101,0,,
2020-02-28,17,118,0,,
2020-02-29,26,144,0,,
2020-03-01,40,184,1,,
2020-03-02,37,221,0,,
2020-03-03,44,265,0,,
2020-03-04,46,311,0,,
2020-03-05,52,363,0,,
2020-03-06,63,426,1,,
2020-03-07,78,504,0,,
2020-03-08,107,611,0,,
2020-03-09,187,798,0,,
2020-03-10,214,1012,1,,
2020-03-11,241,1253,0,,
2020-03-12,297,1550,0,,
2020-03-13,362,1912,0,,
2020-03-14,359,2271,1,,
2020-03-15,454,2725,0,,
2020-03-16,622,3347,0,,
2020-03-17,656,4003,0,,
2020-03-18,782,4785,1,,
2020-03-19,618,5403,0,,
2020-03-20,766,6169,0,,
2020-03-21,668,6837,0,,
2020-03-22,620,7457,0,,
2020-03-23,752,8209,0,,
2020-03-24,667,8876,0,,
2020-03-25,668,9544,0,,
2020-03-26,609,10153,1,,
2020-03-27,610,10763,0,,
2020-03-28,576,11339,0,,
2020-03-29,476,11815,0,,
2020-03-30,621,12436,0,,
2020-03-31,474,12910,0,,
2020-04-01,596,13506,0,,
2020-04-02,518,14024,0,,
2020-04-03,559,14583,0,,
2020-04-04,446,15029,0,,
2020-04-05,459,15488,0,,
2020-04-06,588,16076,0,,
2020-04-07,600,16676,0,,
2020-04-08,598,17274,0,,
2020-04-09,670,17944,0,,
2020-04-10,747,18691,0,,
2020-04-11,709,19400,0,,
2020-04-12,614,20014,0,,
2020-04-13,992,21006,1,,
2020-04-14,798,21804,0,,
2020-04-15,885,22689,0,,
2020-04-16,780,23469,0,,
2020-04-17,849,24318,0,,
2020-04-18,686,25004,0,,
2020-04-19,420,25424,0,,
2020-04-20,646,26070,0,,
2020-04-21,465,26535,0,,
2020-04-22,525,27060,0,,
2020-04-23,509,27569,0,,
2020-04-24,461,28030,0,,
2020-04-25,364,28394,1,,
2020-04-26,261,28655,0,,
2020-04-27,367,29022,0,,
2020-04-28,175,29197,0,,
2020-04-29,104,29301,0,,
2020-04-30,23,29324,0,,
2020-05-01,2,29326,0,,