date,new,cumulative,doubleFlagTest,doubleFlagLabel,shaded
2020-01-15,3,3,1,,18
2020-01-16,0,3,1,,
2020-01-17,0,3,0,,
2020-01-18,0,3,0,,
2020-01-19,0,3,0,,
2020-01-20,0,3,0,,
2020-01-21,1,4,0,,
2020-01-22,2,6,1,,
2020-01-23,0,6,0,,
2020-01-24,2,8,0,,
2020-01-25,1,9,0,,
2020-01-26,0,9,0,,
2020-01-27,1,10,0,,
2020-01-28,1,11,0,,
2020-01-29,0,11,0,,
2020-01-30,0,11,0,,
2020-01-31,0,11,0,,
2020-02-01,3,14,1,,
2020-02-02,0,14,0,,
2020-02-03,0,14,0,,
2020-02-04,0,14,0,,
2020-02-05,1,15,0,,
2020-02-06,0,15,0,,
2020-02-07,0,15,0,,
2020-02-08,1,16,0,,
2020-02-09,1,17,0,,
2020-02-10,1,18,0,,
2020-02-11,0,18,0,,
2020-02-12,1,19,0,,
2020-02-13,2,21,0,,
2020-02-14,4,25,0,,
2020-02-15,4,29,1,,
2020-02-16,3,32,0,,
2020-02-17,1,33,0,,
2020-02-18,2,35,0,,
2020-02-19,1,36,0,,
2020-02-20,5,41,0,,
2020-02-21,3,44,0,,
2020-02-22,6,50,0,,
2020-02-23,9,59,1,,
2020-02-24,11,70,0,,
2020-02-25,10,80,0,,
2020-02-26,6,86,0,,
2020-02-27,12,98,0,,
2020-02-28,17,115,0,,
2020-02-29,25,140,1,,
2020-03-01,39,179,0,,
2020-03-02,36,215,0,,
2020-03-03,44,259,0,,
2020-03-04,46,305,1,,
2020-03-05,50,355,0,,
2020-03-06,59,414,0,,
2020-03-07,76,490,0,,
2020-03-08,103,593,0,,
2020-03-09,181,774,1,,
2020-03-10,212,986,0,,
2020-03-11,235,1221,0,,
2020-03-12,287,1508,0,,
2020-03-13,354,1862,1,,
2020-03-14,356,2218,0,,
2020-03-15,444,2662,0,,
2020-03-16,610,3272,0,,
2020-03-17,651,3923,1,,
2020-03-18,771,4694,0,,
2020-03-19,604,5298,0,,
2020-03-20,750,6048,0,,
2020-03-21,647,6695,0,,
2020-03-22,598,7293,0,,
2020-03-23,726,8019,1,,
2020-03-24,654,8673,0,,
2020-03-25,640,9313,0,,
2020-03-26,597,9910,0,,
2020-03-27,583,10493,0,,
2020-03-28,542,11035,0,,
2020-03-29,445,11480,0,,
2020-03-30,594,12074,0,,
2020-03-31,454,12528,0,,
2020-04-01,565,13093,0,,
2020-04-02,483,13576,0,,
2020-04-03,518,14094,0,,
2020-04-04,382,14476,0,,
2020-04-05,402,14878,0,,
2020-04-06,511,15389,0,,
2020-04-07,523,15912,0,,
2020-04-08,519,16431,1,,
2020-04-09,555,16986,0,,
2020-04-10,582,17568,0,,
2020-04-11,567,18135,0,,
2020-04-12,416,18551,0,,
2020-04-13,760,19311,0,,
2020-04-14,540,19851,0,,
2020-04-15,606,20457,0,,
2020-04-16,510,20967,0,,
2020-04-17,450,21417,0,,
2020-04-18,292,21709,0,,
2020-04-19,148,21857,0,,
2020-04-20,134,21991,0,,
2020-04-21,27,22018,0,,
2020-04-22,0,22018,0,,
2020-04-23,0,22018,0,,